{
  "map" : [
    [
      [3, 3, 3, 3, 3, 3, 3, 1, 1, 1, 3, 3, 3],
      [3, 3, 3, 3, 3, 3, 3, 1, 1, 1, 3, 3, 3],
      [3, 3, 3, 3, 3, 3, 3, 2, 4, 4, 3, 1, 1],
      [3, 3, 3, 7, 7, 7, 7, 2, 4, 4, 3, 3, 1],
      [3, 3, 3, 5, 5, 5, 5, 2, 4, 4, 3, 3, 1],
      [3, 3, 3, 7, 7, 7, 7, 2, 4, 4, 3, 3, 1],
      [3, 3, 3, 3, 3, 3, 3, 2, 4, 4, 3, 3, 1],
      [3, 3, 3, 2, 2, 2, 2, 2, 4, 4, 3, 3, 1],
      [3, 3, 3, 2, 2, 2, 2, 2, 4, 4, 3, 3, 1],
      [3, 3, 3, 2, 2, 2, 2, 2, 4, 4, 3, 3, 1]
    ]
  ],
  "shift" : [0, 0],
  "borders" : {
    "pos_x" : 0,
    "pos_y" : 0,
    "width" : 800,
    "height" : 600
  }
}


