{
  "map" : [
    [
      [3, 3, 1, 4, 4, 4, 3, 3, 2, 2, 2, 2, 2],
      [3, 3, 1, 7, 7, 7, 1, 3, 2, 2, 2, 1, 1],
      [3, 3, 1, 7, 7, 7, 1, 3, 2, 2, 2, 3, 3],
      [3, 3, 2, 2, 2, 2, 2, 3, 3, 3, 3, 3, 3],
      [3, 3, 1, 1, 2, 1, 1, 3, 1, 1, 1, 7, 7],
      [3, 3, 1, 2, 2, 2, 1, 3, 3, 3, 1, 7, 7],
      [3, 3, 2, 2, 1, 2, 3, 3, 1, 3, 1, 1, 3],
      [3, 3, 1, 1, 1, 2, 1, 1, 1, 3, 3, 3, 3],
      [3, 3, 1, 3, 3, 3, 3, 1, 3, 3, 3, 3, 3],
      [3, 3, 1, 3, 3, 3, 3, 1, 3, 3, 1, 3, 3]
    ]
  ],
  "shift" : [0, 0],
  "borders" : {
    "pos_x" : 0,
    "pos_y" : 0,
    "width" : 800,
    "height" : 600
  }
}